#
# 日本語の用語を統一するための、定義ファイルです。
#
# 行形式： 統一用語 : バリエーション１, バリエーション２，…
#
# バリエーション用語に、統一する用語が含まれている場合は指定に注意
# 生成正規表現を吟味し、不適切であれば、スクリプトを調整する必要あり
#

サービスプロバイダ : サービスプロバイダー, サービスプロバーダー, サービスプロバーイダー
ユーザー : ユーザ
スカフォールド : スカフィールド, スキャフォールド
ペジネーション : ペギネーション, ページネーション
サーバ : サーバー
マシン : マシーン
インストーラ : インストーラー
ディレクトリ : ディレクトリー
依存注入 : 依存性注入
ヘルパ : ヘルパー
アクセサ : アクセサー
ミューテタ : ミューティタ―, ミューテタ―
フラグ : フラッグ
クロージャ : クロージャー
ビルダ : ビルダー
クエリ : クエリー
プロパティ : プロパティー
フォルダ : フォルダー
ディレクトリ : ディレクトリー
リポジトリ : リポジトリー
バリデータ : バリデーター, バリデタ
コントローラ : コントローラー
リスナ : リスナー
セレクタ : セレクタ―
ヘッダ : ヘッダー
ハンドラ : ハンドラー
セッション : セション
Redis : Reids
キャッシュ : キャシュ
再生成 : 再生性
